tsichì	i’m showering	X

nchii kusachu’u	what are you going to do?

kunkuchi	I will shower	X

mee ña ntsini	I’ve seen it

“mee ve na” ka’an na	they say “mee ve na”

(n)tikoo sooti	shell	X

ntivi - (espaloso)?

tinto’o luu	small cup (like coffee cup)	X

tinto’o ka’nu	pitcher	X

jòò	big jug	X

nikitsaa savi	it’s starting to rain

tínana soó	small green ‘tomatoes’ with shell	X

tínana	tomatoes	X

soó	shell	X?

chaku something alive, living being,..	X

yoo (moon)	note: uses the pronoun “ti” because it is round (also used with oranges, balls, etc.)
	nstini ti
	ntee ti

nixi kaa yoo?

kuchi	be ripe	X

tiri tina	bumble bee (dog)	X

tiri si’vi 	bumble bee (poop) (use poop to make house)	X

tiri tivaya	bumble bee (pumpkin flower) (likes pumpkin flower)	X

ma kuá’a ka yu ichi	I’m not allowing this	X

nta’a ncho’u	you got fat	X

ntó’o ini yu	I’m worried	X

si(y)aa	to drop	X
	
	siá yu	I drop				X

	kusiá yu	I will drop	X

káxi	to sneeze, desornudar	X

	káxà	I sneeze	X

	káxa	?he/she sneezes?	X

káyi	to cough, toser	X
	
	kayíì	I cough	X

ka’ki’vi	to hiccup, hipo	X

ñé’é	scratch	X
	
	ñé’è	I scratch	X

	niñé’è	I scratched	X

tivisíì	to spit	X

	tivisi yu	I spit	X

xichi la’la	runny nose	X

kiní tsa’an yu’u (+ PRON)	to have bad breath, mal haliente	X

tachi	air, wind, fart	X

tatsa’vi meeni	you’re welcome	X

in so (+ PRON)	be related (‘so’ is emphatic; lit: (PERS) be one)	X

ta’an (kuu)	be related (?)	X (need example)

sata	peel of fruit	x

ka’nu	to break	X

	tsa’nù	I break	X

	ntsà’nù	I broke	X

	kunka’nu	I will break	X


ntaka’nu	to bend

vá’a ra nisa’a na ve’e ka	the house was well built	X

tsito (+ PRON)	take care	X

ntasa’a xu’un na ntávi yu	I paid back the money I owed (Note: ’ntávi’ ‘poor’)	X

naa	to carry	X

nti’o	all of us (inflected form of “nti’i” ‘all’)	x

ntakasi	to close	X

	ntakasi	yu	I close	X
	
	ntakasu	you close	X

	ntakasi ni	you (form) closes	X

kuna	to open	X

	tsunà	I open	X
	
	tsuna ku	you open	X

	tsuna ko	we (excl) open	X

	tsuna kue	we (incl) open (note: Ijenio says this is for 2-3 people…)	X

	kunkunà	I will open	X


ntsì’ì	I drank	X


michu’ni ~ michumi	(note: variants of the same word)	X

kanti ~ ka’nti	(note: variants of the same word - what does it mean!?)

sana vá’a ni	later is fine	X

tsáni	dream	X

	tsáni yu	I dream	X

meeku	brown	X

Note: “nti-“ prefix used in colors is likely from “nti’i” all	X

ntiká’an	jaguar, (any big cat)	X

ti’ìn ita	skunk	(Note: not “ti’in xeen”)	X

ña va’a ka	better	X

tsa’an	smell, huele, oler	X
	
nto’o	suffering	X

tintixi	pomegranite	X

tikiì	blister	X

táta	father	(likely the native term)	X

tata	crops, cultivos	X

kivi	enter	X

	kívì	I enter	X

	kunkivì	I will enter	X

in ka (+ N)	last one	X

	in ka paan inkaa	there is one last bread	X

ika kuya’vi nchai	food is sold there	X

ika kuya’vi na nchai	they sell food there	X

tatsa ntuu	sunrise	X

ntsinu	nikanchii	sunrise	X

ntee nikanchii	sunset	X

tatsa savi	thunder	X
	
Yòkò	spirit that steals things	X

ntusu	sound	X

ntusu yú’u	voice 	X

	ntusu yú’ù	my voice	X

ka’an so (+ PRON)	speak up	X

tsito	watch, be visible	X

	tsítò	I am visible, watching?	X

tekiu	required community service (loan word from Nahuatl “tequitl” -get link to source!-)	X

tuu vatsì karru ka	I see the car coming	X

ichí	sillouette (from ‘path’)	X

nisa ta sutu kaa?	how full is it?	X

kuanta’vi	shadow	X

ntúva	split, separate	X

ntachi 	split, separate (? is this the same word as ‘to fall’?)	X

kakú	to be born	X

nikakú

ká’un	to hurt	X

ká’un ana	to hurt, be sad (literally or metaphorically)	X

	ká’un ana {yu, ku, ña,..}	X


ká’un ini	to hurt, be sad (literally or metaphorically)	X

ká’un titsi	X

	ká’un titsì	I have a stomach ache	X

	ká’un titsú	you have a stomach ache	X

	ká’un titsia	X

	ká’un titsi ra	X

	ká’un titsi ñá	X

	ká’un titsi kó	X


ntàku	(be) strong	X

sutsa	tree sap	X

Mina	Los Tejocotes	X(later)

kuni	to know	X

	tsini yu	X

	ntsitsini yu	(I used to know	X
	
	kunkuni yu	I will know	X

	ntsini yu	 I don’t know	X

(NOTE: kúni yu kuni yu	 I want to know)	X

kití ki’in tòóò	geometro (type of caterpillat w/no legs in middle)	X

ana = anua	(variant of heart in Santa Cruz Mix)


Nkoso	San Lukas (Mixtepec?)	X(later)

ita tivaya	pumpkin blossum, flor de calabaza	X

tixantuchí	oruga	X

———————————————————————————

tika tuchá	madron catterpilar, gusano elotero (caterpilar that lives in “skà’ma itu
“)

itsintuchi	(catterpilar that has head that looks like a snake) hawk-moth catterpillar?(Hemeroplanes Triptolemus)


skó’o	black fuzzy catterpillar (larva)

tirri skuu titsí	dung beetle

skuanchii	preying mantis

tika kolo	?

tika kiti	(black cricket w/ yellow stripes on legs)

tika sutu	chapulin sacerdote

tika yutsa	(cricket with yellow and blue wings)

chú’un	ntikuá’a	type of black widow, viuda negra

choko kuá’a	red ants

choko rieru hormiga ariera

choko chú’un	(hairy ant; grey with yellow bottom)

tirir tì (stami)	(type of bumble bee)

chú’un xaa	opillion (not actually a spider)

kòo ñu’ún	? (type of snake) (ñu’un is “fire”)

koo tútu	? (type of snake that looks like cow intestines) 

koo savi	(mythical feathered snake)

koo tumi	(mythical snake w/ feathers on head)

xìtu	algee

xítú	bloomed bud

numá	tree trunk	X

nta’ini	cilantro

yee (+ PRON)	greeting (hello)

sana toko	goodbye

sana ka’an	goodbye

ncháàá	not, aun, have not

ntà’à	to mount, have sex

kuaán	have sex	X

ntó’yo	marsh

píla	water tank

laguna	lake
(chikuii ka’nu)	lake

kancha’u	move (out of the way)!

nikancha’à	I moved

kutsiu	excuse me, con permiso

chita’an	to bind, agree (“chi” + “ta’an”)

ntachi	to fall

	ntáchì	I fall

	kuntachì	I will fall

nia	all

va’a ni	it’s fine

ntaa ka’un	speak directly	X

ñú’un	respect

iñú’un ncho’a	(be) very respectful

yokó	bloomed flowered plant (corn & wheat)

	yokó itú	cornfield in bloom

trígu	wheat

yokó trígu wheat in bloom

xátu luu	youngest (kid, baby)

ña xina ñú’un	first, oldest (to be the oldest)

xina	first

té’e	vine	X

chisu	beetle

kuañú’in	be careful  (syn: “xeen”)

kuañú’in ra	be careful (of a liquid e.g. pulque)

kuita xeen	I’m tired

a ntitato

santá’a 	echo

yaka níìí	corn storage house

nchika 	hide

	nchíka	I hide	(nchika se’e yu)	
	
	kunchika	I WILL hide

	nchìka

chivi	fireflies

tsa ntee yoo	?	(tsa - already)

a ntakoo va’a ni?	(good morning)

a ntuu vaa (ni)?	did you sleep well? (good morning) (lit: did the sun rise well for you?)

(resp)
	> va’a ni

	> aan ntuu va’a

a ntsa ntakoo (ni)?

(resp)
	> ntsa ntakoo

a ntuu va’u see? (Note: with child or younger person)

see	young person

nchii kunku’un chaa see tsàan?	where is the young man going?


a ntitato	?

íchi yu	I’m thirsty

tsí’i yu sōkō	I’m thirsty

matsíchi	machete

xāxā	blatter

sókō	uterous

sòkō	condemn

ni sòkí	?

tá’an ini	to like	X

tá’an ini yāā yó’ó	I like this music	x

kue tá’an ini yu vilu	I don’t like cats	X

nchii kachu?	what are you talking about?	X

ka’ki’vi	to hiccup	X

tintuú	pit (not seed)	X

síva	seed	X

tívì ini	to have a hangover	X

sí’vi	be called	x

sì’vi	shit	X

skíti	to boil	X

yatsi	bowl	X

tuku	also	X

sta’ví	to lie, to tell lies	X

	stá’vi yu	I lie	X

	stá’via 	he/she/it lies	X


	stà’vi yu	I lied	X

	kusta’vi yu	I will lie	X

	kusta’via	he/she/it will lie	X


stà’vu yu	you lied to me	X

ntakaní ntaa	tell the truth	x

	ntakáni ntaa yu	I tell the truth	X

	ntakáni ntai	he/she/it tells the truth	X
	
	kuntakáni ntaa yu	I will tell the truth		X

	ntakàni ntaa yu 	I told the truth	X	


na Nkoyo	Aztecs	X



tikuáin	mosquito, sangudo	X

tìse’é	1) small mosquito that doesn’t make noise;	X	2) twigs	X

ntuu	picar, sting (e.g. what mosquitos do)

ntuu ñuñu yu	the bee stung me


ki’vi	interrupt (lit: to enter)	X

	ki’vì	I interrupt	X

	niki’vì	I interrupted	X

	kunki’vì	I will interrupt	X

nikachi ta’an kue tu’un 	 we came to an agreement	X

sa’u ña nakua’ni	?

nuu naa 	to take care of	X

naka	them	X

ñaka	that (person)	X

inñu’ún 	respect	X

ntantuku	to look for, pick up	X

yú’ú	to be scared	X

	yú’ú yu	I’m scarred	X	

	yú’i	he/she/it is scarred	x

tsini	to get drunk	X

	tsinì	I am drunk	x

	tsinú	you are drunk	X
	
	tsini kó	we are drunk	X
	

	ntsinì I got drunk	X

	ntsini kó	we were drunk	X


	kuntsinì	I will get drunk	X


yùchi	knife, cuchillo	X

ntikà’ā	“tigre”, lynx, jaguar?	X

tikoso	cricket, grillo	X


ka’an yu xoo na 	I speak a little

í’ín	sweat lodge, baño de vapor	X

yoso	llano	X

	
nikàa	too much	X

nikaa ntixi tsi’i ra	he drank too much pulque	X

tian	except	X

ta’an ini yu nti’i so kuñu tian kuñu chuun.	I like all meat except chicken.	X

kuu sandi	last day (time)	X	

samitu’un	last (object)	X

tsitu ini (or “kutu ini”?)	to realize	X
	
	tsitu (n)ini yu	I realize	x
		
	tsitu (n)inia	he/she/it realizes	X


	ntsitu (n)ini yu	I realized	X

	kunkutu (n)ini yu	I will realize	X

kunchee	to be able to	x

ntasi	tickle, (ticklish)?	X

nikixi yu	I slept	X

boti	bottle	X	

katsi (va’a | va’á)	to taste (good | bad, etc.) x


chá'ma  	capullos, larva	X

nchika	to put	X

stiìn	yo pego, I stick (?)	X

se’è	child	X

	se’è yu 	my child	X

	se’ú	your child	X

tsà’ví	gum	X

táví	pains	X

ntixií	selfish, egoista	X

	ntixiíì 	I am selfish	X

u’u ini 	envy, jelousy	X

(ña-) kuiñù	jelousy (between two siblings)	X

tikoo	tamales	X

(tsa)ntùúcha	ocean (antiquated)	X

tatsa savi	thunder	X

ntá’a	to grow back	X

kuka nuu	shame	X	

	kuka nuù	1sg (?) I am ashamed(?)	X


tata na'a	first/early harvest, premier cosecha; first thing planted	X

ko’yo	humid	X

ntuu	to become	X

ntasaá	to heat up (staa, chikuii,..)	X

Tsika kue nuu kue cha niya’a kue in nuu inkaa in yucha luu	We walked, we came down and  crossed over to a place where there is a small lake.	X

Tsika kue nuu kue cha niya’a kue in ñuu nuu inkaa in yucha luu	X

skà(‘)ma itú	edible fungus that grows on corn kernal	X

sañu’ma 	to (make?) smoke	X

vixi	(insult)	X

(ku)nti tatu	to rest	?(Note: not clear if “nti”+”tatu” is one word!)	X

	(ku)nti tatu yu	I rest 	X

tsituni(?)	to understand(?)

ñuu Yuku Titu’un

ñuu Nkuiin

ñuu Yuku Mi’in 	nuu nto(?) toto yaa

ñuu Xini Yuku	Loma Redonda

ñuu Toto Utsa	porque hay piedras muy grandes (piedras rojas grandes)


Note: MIX from Santa Maria Teposlatongo doesn’t use formal “ni”	


nintata tu	it separates	(note: what is basic form of this verb!?)

skaka	drive

	skáka	(pres)

	skàka	(past)

ntsìsò	I jumped

ntsìtù	 I planted

ntsì’ì yu	I died

ntsìkà	I walked

nintakanini yu	I thought

kúni yu skua’a	I want to learn

ta kua….	(note: second verb doesn’t conjugate following this)

kuena	(note: can be contrete noun, unit of people)

nkua’à	I will not give

iin ña va’a	some are good

iin ña va’á	some are bad

ika tá’an ini yu katsi taku	I like to eat tacos  there.

tatsa’vi ni xowa	(yuk) thanks very much

“kutu ini”	to realize (syn)?

(na)ntoo	?

tuyu'ntu, tuyuntu	?

tsà’vi	?

koo tisuchi	?

xchá'ma 	?

loma ve’e savi	?

nko’o kasinó	?

kó’ó	? 

yavi kó’o	?

cha ña…	(filler interjection often used in beginning sentences)